###############
#             #
#    X        #
#   ##   ##   #
#   ##   ##   #
#             #
#             #####
#   # . . #      @#
#   #######       #
#        X        #
#                 #
###################